en	[smacking lips] | 

en	[Walter] Oh! You must be Mrs. Dubois! 
ar	‫لا بد أنك السيدة "دوبوا".‬ | 
cs	Vy budete určitě paní Duboisová. 
da	Du må være fr. Dubois. 
el	Θα είστε η κυρία Ντουμπουά. 
fi	Olette varmaan rouva Dubois. 
fr	Vous devez être madame Dubois. 
he	‫את בטח גברת דובואה.‬ | 
hu	Maga biztosan Mrs. Dubois. 
it	Lei dev'essere la sig.ra Dubois. 
ko	뒤부아 부인이시군요 
ms	Awak tentu Pn. Dubois. 
nl	U bent vast Mrs Dubois. 
pt	Deve ser a Sra. Dubois. 
sv	Du måste vara mrs Dubois. 
th	คุณคงเป็นคุณนายดูบัวส์ 
tr	Bayan Dubois siz olmalısınız! 
vi	Hẳn bà là bà Dubois. 
zh-long	妳一定是杜布瓦太太 
zh-short	你就是杜布瓦太太吧 
ru	Вы, верно, миссис Дюбуа? 
es-eu	Usted debe de ser la señora Dubois. 
de	Sie müssen Mrs. Dubois sein. 
es	Usted debe ser la señora Dubois. 
no	Å, du må være Mrs. Dubois. 
pt-br	Você deve ser a Sra. Dubois. 
ja	&lrm;デュボワさん？ | &lrm;私はウォルターだ | 
hr	Vi mora da ste gđa Dubois! 
ro	Presupun că sunteți dna Dubois. 
id	Kau pasti Nyonya Dubois. | 
pl	Pewnie pani Dubois. 

