en	[all laughing] | 

pt	Porque estamos a gritar? 
es	¿Por qué gritamos? 
en	What are we screaming at? 
id	Kenapa berteriak? | 
ro	De ce țipăm? 
hr	Zašto urlamo? 
el	Γιατί ουρλιάζουμε; 
ko	우리 왜 소리 지르지? 
ru	Из-за чего кричим? 
ar	‫لماذا نصرخ؟‬ | 
cs	Co tady křičíte? 
da	Hvorfor skriger vi? 
es-eu	¿Por qué gritamos? 
fi	Miksi huudamme? 
fr	Pourquoi on crie ? 
he	‫על מה אנחנו צורחים?‬ | 
it	A cosa stiamo urlando? 
nl	Waarom gillen we? 
pl	Dlaczego krzyczymy? 
sv	Vad skriker vi för? 
th	จะกรี๊ดกันทำไมนี่ 
vi	Sao ta lại hét? 
zh-long	我們在叫什麼？ 
zh-short	我们在喊什么？ 
ms	Kenapa kita menjerit? 
tr	Niye çığlık atıyoruz? 
de	Warum schreien wir? 
ja	&lrm;なんで叫ぶ？ | 
no	Hvorfor skriker vi? 
pt-br	Por que estamos gritando? 
hu	Miért kiabálunk? 

