en	[all cheering] | 
ja	“３位” | 

es	Ya se transformó por completo. 
ar	‫اكتمل التحول.‬ | 
cs	Proměna je dokončena. 
da	Forvandlingen er fuldendt. 
el	Η μεταμόρφωση ολοκληρώθηκε. 
en	The transformation is complete. 
es-eu	Transformación completa. 
fi	Muodonmuutos on valmis. 
fr	La transformation est terminée. 
he	‫השינוי הושלם.‬ | 
it	La metamorfosi è completa. 
ms	Perubahan sudah lengkap. 
nl	De transformatie is voltooid. 
pt	A transformação está completa. 
ru	Трансформация завершена. 
sv	Förvandlingen är fullbordad. 
th	การแปลงร่างเสร็จสมบูรณ์ 
tr	Dönüşüm tamamlanmış. 
vi	Sự biến đổi đã hoàn tất. 
zh-short	变身完成了 
de	Die Verwandlung ist vollendet. 
hu	Az átalakulás befejeződött. 
ja	&lrm;変身完了か | 
ko	완전히 변신해 버렸네 
no	Forvandlingen er fullført. 
pl	Twoja przemiana dobiegła końca. 
pt-br	A transformação está completa. 
zh-long	變身過程結束了 
ro	Transformarea e completă. 
hr	Preobrazba je potpuna. 
id	Perubahan wujudnya sudah sempurna. | 

