en	[pager beeping] | 

es	Señor Lambert. 
ar	‫يا سيد "لامبرت".‬ | 
cs	Pane Lamberte? 
da	Hr. Lambert. 
de	Mr. Lambert. 
el	Κύριε Λάμπερτ. 
en	Mr. Lambert. 
es-eu	Señor Lambert. 
fi	Herra Lambert. 
fr	Monsieur Lambert. 
he	‫מר למברט.‬ | 
hr	G. Lambert. 
hu	Mr. Lambert! 
id	Tuan Lambert. | 
it	Sig. Lambert. 
ja	&lrm;ランバート… | 
ko	램버트 씨 
ms	En. Lambert. 
nl	Mr Lambert. 
no	Mr. Lambert. 
pl	Panie Lambert. 
pt-br	Sr. Lambert. 
pt	Sr. Lambert. 
ru	Мистер Лэмберт. 
sv	Mr Lambert. 
th	คุณแลมเบิร์ต 
tr	Bay Lambert. 
vi	Ông Lambert. 
zh-long	蘭伯特先生 
zh-short	兰伯特先生 
ro	Dle Lambert. 

