en	-[exclaims] | -[raccoon screeches] | 

es	¡Mami! ¡No! ¡Ayúdame, mami! 
no	Mamma! Nei!  
ar	‫يا أمي! لا! ساعديني يا أمي!‬ | 
cs	Mami! Ne! Pomoz mi, mami! 
da	Mor! Nej! Hjælp mig, mor! 
de	Mami! Nein! Hilf mir, Mami! 
el	Μαμάκα! Όχι! Βοήθησέ με, μαμάκα! 
en	Mommy! No! Help me, Mommy! 
es-eu	¡Mamá! ¡No! ¡Ayúdame, mamá! 
fi	Äiti! Ei! Auta minua, äiti! 
fr	Maman ! Non ! À l'aide, maman ! 
he	‫אמא! לא! הצילו, אמא!‬ | 
hr	Mamice, ne! Upomoć, mamice! 
hu	Anyu! Ne! Anyu, segíts! 
it	Mamma! No! Aiutami, mamma! 
ja	&lrm;ママ！　助けて！ | 
ko	엄마! 나 좀 살려줘요! 
ms	Ibu! Tidak! Tolong saya, ibu! 
nl	Mama. Nee. Help me, mama. 
pl	Mamusiu! Nie! Pomóż mi, mamusiu! 
pt-br	Mamãe! Não! Socorro, mamãe! 
pt	Mamã! Não! Ajuda-me, mamã! 
ro	Mami! Nu! Ajută-mă, mami! 
sv	Mamma! Nej! Hjälp mig, mamma! 
th	แม่จ๋า ไม่นะ ช่วยด้วย แม่จ๋า 
tr	Anne! Hayır! Yardım et anneciğim! 
vi	Mẹ ơi! Không! Mẹ ơi cứu con! 
zh-long	媽咪！不行，救救我，媽咪！ 
zh-short	妈妈！不要！救命啊 妈妈！ 
id	Ibu! Tidak! Bantu aku, Bu! | 
ru	Мама! Нет! Помоги мне, мама! На помощь! 
no	Hjelp meg, mamma! 

