ja	一流を集めた　リストを送る | 
ru	С лучшими. 
id	Ya, yang paling terkenal. 

ru	Хороших людей? 
ar	‫شخصان طيبان؟‬ | ‫كل ما فعله هذان الاثنان هو الإساءة إليك.‬ | 
cs	Dobrým lidem? Ti dva vás pořád jen šikanovali. 
da	Gode folk? De to har altid kun plaget dig. 
de	Die Guten? Die beiden haben Sie nur schikaniert. 
el	Καλούς ανθρώπους; Αυτοί οι δύο μόνο σε κακομεταχειρίζονταν. 
en	Good people? All those two ever did was abuse you, man. 
es	¿Buena gente? Esos dos se la pasan molestándote. 
es-eu	¿Buena gente? Si son quienes se meten contigo, tío. 
fi	Hyville ihmisille? Ne kaksi vain kiusasivat sinua. 
fr	Ces bons gens ? Ils n'ont fait que te maltraiter. 
he	‫אנשים טובים?‬ | ‫שניהם רק התעללו בך כל הזמן, בנאדם.‬ | 
hr	Dobrim ljudima? Ta su te dvojica stalno zlostavljala, čovječe. 
hu	Jó emberek? Folyamatosan csak bántottak téged. 
id	Orang baik? | Mereka berdua selalu mengusikmu. | 
it	Persone buone? Quei due ti hanno sempre molestato. 
ja	&lrm;善人？ | &lrm;あんたに悪事ばかりしてる | 
ko	선량한 사람들요? 둘 다 당신 엄청 괴롭혔잖아요 
ms	Orang baik? Mereka selalu buli awak, En. Dubois. 
nl	Goede mensen? Die twee zijn alleen maar gemeen tegen je geweest. 
no	Gode mennesker? De har ikke gjort annet enn å plage deg. 
pl	Dobrym? Ci dwaj ciągle cię wykorzystywali. 
pt	Boas pessoas? Os dois apenas o maltratavam. 
pt-br	Pessoas boas? Eles sempre maltrataram você, cara. 
ro	Om bun? Te-au tratat amândoi groaznic. 
sv	Gott folk? De behandlade dig alltid illa, mannen. 
th	คนดีๆ เหรอ สองคนนั่นชอบแกล้งคุณตลอดนะ 
tr	İyi insanlar mı? O ikisinin tek yaptığı seni taciz etmekti. 
vi	Người tốt? Hai người bọn họ toàn trêu chọc chú. 
zh-long	好人？他們一天到晚欺負你耶，老兄 
zh-short	善良的人？ 那两个人总是欺负你 先生 
ru	Да эти двое издевались над вами. 

