en	I protect her 24/7! | 
id	Aku melindunginya setiap saat! 
ru	Что я и делаю круглые сутки! 
ja	24時間 守ってる！ | 

ar	‫حسنًا يا "بلايك". فهمت. شكرًا.‬ | 
cs	Dobře, Blakeu. Rozumím. Díky. 
da	Okay, Blake. Godt, tak. 
de	Alles klar, Blake. Danke. 
el	Εντάξει. Κατάλαβα. Ευχαριστώ. 
en	All right, Blake. I got it. Thank you. 
es-eu	Muy bien, Blake. Gracias. 
es	Muy bien, Blake. Gracias. 
fi	Hyvä on, Blake. Kiitos. 
fr	D'accord, Blake. Compris. Merci. 
he	‫בסדר, בלייק. אני מטפל בזה. תודה.‬ | 
hr	U redu, Blake. Shvaćam. Hvala ti. 
hu	Rendben, Blake. Értem. Köszönöm! 
id	Baiklah, Blake. Aku paham. Terima kasih. | 
it	Va bene, Blake. Ho capito. Grazie. 
ja	&lrm;ブレイク　ありがとよ | 
ko	알았어, 블레이크, 고마워 
ms	Baiklah, Blake. Terima kasih. 
nl	Duidelijk, Blake. Bedankt. 
no	Det er mottatt. Takk. 
pl	Dobra, Blake. Rozumiem. Dziękuję. 
pt-br	Certo, Blake. Entendi. Obrigado. 
pt	Certo, Blake. Entendi. Obrigado. 
ro	Bine, Blake! Am înțeles. Mersi. 
ru	Ладно, Блейк. Понял. Спасибо. 
sv	Okej, Blake. Jag fattar. Tack. 
th	เอาละ เบลค ฉันเข้าใจแล้ว ขอบใจนะ 
tr	Anladım Blake. Sağ ol. 
vi	Được rồi, Blake. Hiểu rồi. Cảm ơn. 
zh-long	好，布萊克，我知道了，謝謝 
zh-short	好了 布莱克 我知道了 谢谢你 

