en	[sobbing loudly] | 

ar	‫هذا صوتي الحقيقي.‬ | 
cs	Tohle je můj skutečnej hlas. 
da	Det her er min stemme. 
en	This is my real voice. 
es-eu	Esta es mi verdadera voz. 
fi	Tämä on oikea ääneni. 
fr	C'est ma vraie voix. 
he	‫זה הקול האמיתי שלי.‬ | 
hr	Ovo jest moj pravi glas. 
hu	Ez az igazi hangom. 
it	Questa è la mia vera voce. 
ms	Inilah suara sebenar saya. 
nl	Dit is mijn echte stem. 
pl	To mój prawdziwy głos. 
pt	Esta é a minha voz real. 
th	นี่แหละเสียงจริงๆ ของฉัน 
vi	Đây là giọng thật của tôi. 
zh-long	我的聲音就是這樣 
zh-short	这就是我的真实声音 
sv	Det här är min riktiga röst. 
de	Das ist meine echte Stimme. 
ko	이게 내 목소린데 
el	Αυτή είναι η αληθινή μου φωνή. 
es	Esta es mi verdadera voz. 
ja	&lrm;本当の声よ | 
pt-br	Esta é a minha voz de verdade. 
no	Dette er min stemme. 
id	Ini suara asliku. | 
tr	Bu gerçek sesim. 
ru	Это мой настоящий голос. 
ro	Asta e vocea mea adevărată. 

