en	[continues sobbing] | 

nl	Ik ben een groot fan van uw man, Aurora. 
ar	‫أنا معجب كبير بزوجك "أورورا".‬ | 
cs	Jsem velký fanda vašeho manžela, Aurory. 
da	Jeg er en stor fan af din mand, Aurora. 
de	Ich bin ein großer Fan Ihres Mannes. 
en	So, I am a big fan of your husband, Aurora. 
es	Admiro mucho a su esposo, Aurora. 
es-eu	Soy fan de su marido, Aurora. 
fi	Olen aviomiehenne Auroran suuri fani. 
fr	Je suis un grand fan de votre mari, Aurora. 
he	‫אז אני מעריץ גדול של בעלך, אורורה.‬ | 
hu	Nagy rajongója vagyok a férjének. 
it	Sono un grande fan di suo marito, Aurora. 
ja	&lrm;僕はオーロラの大ファンだ | 
ko	제가 오로라의 광팬이거든요 
ms	Saya peminat suami awak, Aurora. 
no	Jeg er fan av mannen din, Aurora. 
pl	Jestem fanem twojego męża, Aurory. 
pt-br	Bem, sou grande fã do seu marido, Aurora. 
pt	Sou uma grande fã do seu marido Aurora. 
sv	Jag är ett stort fan av din make. 
th	ผมเป็นแฟนตัวยงของออโรร่าสามีคุณ 
tr	Kocanız Aurora'nın büyük hayranıyım. 
vi	Tôi là người hâm mộ chồng cô, Aurora. 
zh-long	我是妳先生歐蘿拉的忠實聽眾 
zh-short	我是你丈夫欧若拉的超级粉丝 
el	Είμαι μεγάλος φαν του άντρα σας. 
hr	Veliki sam fan vašeg supruga, Aurore. 
id	Aku penggemar berat suamimu, Aurora. | 
ru	Я большой поклонник вашего мужа Авроры. 
ro	Sunt mare fan al soțului tău, Aurora. 

