en	-[Gary screams] | -[people gasp] | 

es	Come. 
ar	‫ابدأ الطعام.‬ | 
cs	Papej. 
da	Spis løs. 
de	Beiß rein. 
el	Φάε. 
en	Dig in. 
es-eu	A comer. 
fi	Käy kiinni. 
fr	Fais un croc. 
he	‫בתיאבון.‬ | 
hu	Együnk! 
it	Dacci dentro. 
ja	&lrm;ほら | 
ko	물어 
ms	Makan. 
nl	Tast toe. 
no	Hogg inn! 
pl	Smacznego. 
pt-br	Mande ver! 
pt	Toca a comer. 
ro	Poftă bună! 
ru	Налетай. 
sv	Hugg in. 
th	เขมือบเลย 
tr	Yumul. 
vi	Ăn đi. 
zh-long	吃吧 
zh-short	吃吧 
id	Makanlah. | 
hr	Navali.. 

