ja	サンディ･ウェクスラー | 

cs	Kde? 
da	Hvor? | 
el	Πού; 
en	Where? 
es	¿Dónde? 
es-eu	¿Dónde? 
fi	Mistä? | 
fr	Où ça ? 
he	‫איפה?‬ | 
hr	Gdje? 
hu	Hol? 
id	Di mana? 
it	Dove? 
ja	&lrm;どこで？ | 
ko	&lrm;어디요? | 
ms	Di mana? 
nl	Waar? 
no	Hvor? 
pt-br	Onde? 
pt	Onde? 
ro	Unde? 
ru	Где? 
sv	Var då? 
th	&lrm;ที่ไหน | 
tr	Nerede? 
uk	Де? 
vi	&lrm;Ở đâu? | 
zh-long	在哪裡？ 
zh-short	在哪里？ 

