en	[sighs] | 

vi	Phản đối! Yêu cầu đơn vị vũ trang đến khu vực đó. Hết. 
ar	‫أرفض ذلك! أطلب ذهاب الوحدات المسلحة‬ | ‫إلى تلك المنطقة. حوّل.‬ | 
cs	Negativní! Žádám o přesun ozbrojených oddílů. Přepínám. 
da	Negativ! Send bevæbnede enheder. Slut. 
de	Negativ! Fordere bewaffnete Einheiten an. Over. 
el	Αρνητικό! Ζητώ ένοπλες μονάδες στην περιοχή. Όβερ. 
en	Negative! Request armed units to that vicinity. Over. 
es-eu	¡Negativo! Solicitar unidades armadas. Cambio. 
es	¡Negativo! Debe enviar agentes armados. Cambio. 
fi	Ei! Pyydän aseistettua yksikköä sijaintiin. Loppu. 
fr	Négatif ! Demande des unités armées dans mon quartier. À vous. 
he	‫שלילי! מבקש יחידות חמושות‬ | ‫שישמרו על האזור הזה. עבור.‬ | 
it	Negativo! Richiedi unità armate in quella zona. Passo. 
ja	&lrm;ダメだ！ | &lrm;武装した部隊を送って | 
ko	안 된다, 무장한 대원들을 그쪽으로 파견하라, 오버 
nl	Nee. Stuur gewapende eenheden. Over. 
no	Nei. Send en væpnet patrulje. Over. 
pl	Brak zgody! Wyślij tam oddziały zbrojne. Odbiór. 
pt-br	Negativo! Solicite unidades armadas para a vizinhança. Câmbio. 
pt	Negativo! Peço unidades armadas àquele local. Terminado. 
th	ไม่ได้ ส่งหน่วยติดอาวุธไปยังพื้นที่นั้น เปลี่ยน 
tr	Olumsuz! Bölgeye derhâl silahlı birim istiyorum. Tamam. 
zh-long	不行！請派霹靂小組到附近，完畢 
zh-short	不行！请求武装人员去附近 完毕 
hr	Negativno! Šalji oružane jedinice na lokaciju. Prijem. 
hu	Negatív! Kérjen fegyvereseket a környékre! Vége. 
sv	-Nej! Be om beväpnade enheter. Kom. -Förlåt. Jag kan inte avvara personal. 
ms	Negatif! Memohon pasukan bersenjata ke lokasi itu. 
ro	Negativ! Solicit oameni înarmați în zonă. Terminat. 
ru	Ни в коем случае! Отправь туда вооруженных людей. 
id	Minta unit bersenjata ke daerah itu. | 

