en	[both laugh] | 

ar	‫لا أعرف.‬ | 
cs	Netuším. 
da	Aner det ikke. 
de	Ich weiß es nicht. 
el	Δεν ξέρω. 
en	I don't know. 
es-eu	No lo sé. 
es	No sé. 
fi	En tiedä. 
fr	Je ne sais pas. 
he	‫אני לא יודע.‬ | 
hr	Pojma nemam. 
hu	Nem tudom. 
id	Entahlah. | 
it	Non lo so. 
ja	&lrm;さあな | 
ko	난들 아냐 
ms	Entahlah. 
nl	Geen idee. 
no	Jeg vet ikke. 
pl	Nie wiem. 
pt-br	Eu não sei. 
pt	Não sei. 
ro	Nu știu. 
ru	Не знаю. 
sv	Jag vet inte. 
th	ฉันก็ไม่รู้ 
tr	Bilmiyorum. 
vi	Tôi chịu. 
zh-long	我不知道 
zh-short	不知道 

