en	[rock music playing] | 

ar	‫أي يقطينة؟‬ | 
cs	Jaká dýně? 
da	Græskar hvad? 
de	Kürbis was? 
el	Τι κολοκύθα; 
en	Pumpkin what? 
es	¿Calabaza qué? 
es-eu	¿Calabaza, qué? 
fi	Kurpitsa mitä? 
fr	Quoi, citrouille ? 
he	‫דלעת מה?‬ | 
hr	Što s bundevom? 
hu	Milyen tökfej? 
id	Labu apa? | 
it	Zucca cosa? 
ja	&lrm;カボチャが何？ | 
ko	펌킨이 왜? 
ms	Labu apa? 
nl	Pompoen wat? 
no	Gresskar, hva? 
pl	Co dynia? 
pt	Abóbora o quê? 
pt-br	Abóbora o quê? 
ro	Dovleac ce? 
ru	Тыква… что? 
sv	Pumpa vad? 
th	ฟักทองอะไร 
tr	Ne balkabağı? 
vi	Bí ngô gì cơ? 
zh-long	南瓜什麼？ 
zh-short	南瓜怎么了？ 

