id	Ya? 

ar	‫لم استغرقت كل هذا الوقت؟‬ | 
cs	Proč ti to trvalo tak dlouho? 
da	Hvad ventede du på? 
de	Warum hast du so lange gebraucht? 
el	Γιατί άργησες τόσο; 
en	What took you so long? 
es-eu	¿Por qué has tardado tanto? 
es	¿Por qué tardaste tanto? 
fi	Mikä sinulla kesti? 
fr	Tu en as mis du temps. 
he	‫מה לקח לך כל כך הרבה זמן?‬ | 
hr	Što si čekao? 
hu	Mi tartott ilyen sokáig? 
id	Kenapa kau lama sekali? | 
it	Perché ci hai messo tanto? 
ja	&lrm;気づかないなんて | 
ko	왜 이제야 말해? 
ms	Kenapa lambat sangat cakap? 
nl	Waarom duurde het zo lang? 
no	Hvorfor har det drøyd sånn? 
pl	Czemu to trwało tak długo? 
pt-br	Por que você demorou tanto? 
pt	Porque demoraste tanto? 
ro	Ce ți-a luat atât? 
ru	Почему ты так долго молчал? 
sv	Varför dröjde du så? 
th	ทำไมถึงได้บอกฉันช้านักล่ะ 
tr	Niye bu kadar bekledin? 
vi	Sao cậu lâu thế? 
zh-long	你怎麼到現在才說？ 
zh-short	你怎么比我晚一年？ 

