en	[both laughing] | 

ja	&lrm;位置を確認 | 
ar	‫أتلقّى موقعًا. انظر إلى هذا يا "ستيف".‬ | 
cs	Tak už mám lokaci. Steve, podívej. 
da	Jeg får lokationen. Steve, se her. 
de	Ich habe einen Standort. Steve, sieh dir das an. 
el	Εντοπίζω την τοποθεσία. Στιβ, κοίτα. 
en	I'm getting a location. Steve, look at this. 
es-eu	Tengo la dirección. Mira esto. 
es	Tengo una ubicación. Steve, mira. 
fi	Saan sijainnin. Katso tätä, Steve. 
fr	Le téléphone est localisé. Steve, regarde. 
he	‫אני מקבל מיקום.‬ | ‫סטיב, תראה את זה.‬ | 
hr	Hvatam lokaciju. Steve, pogledaj. 
hu	Bemértem a helyzetét. Ezt nézd, Steve! 
id	Aku mendapatkan lokasi. Steve, lihat ini. | 
it	Lo sto localizzando. Steve, guarda qui. 
ko	위치 나왔습니다 스티브, 이것 보세요 
ms	Saya dapat lokasi. Steve, tengok ini. 
nl	Ik heb een locatie. Steve, kijk eens. 
no	Nå peiles det inn et sted. Steve, se her. 
pl	Sprawdzam lokalizację. Steve, spójrz tu. 
pt-br	Encontrei uma localização. Steve, veja isto. 
pt	Já tenho localização. Steve, olha para isto. 
ro	Am localizat telefonul. Steve, ia uite! 
ru	Я засек местоположение. Стив, взгляни. 
sv	Jag får fram en plats. Kolla här. 
th	ฉันได้ตำแหน่งแล้ว สตีฟ ดูนี่สิ 
tr	Konum buldum. Steve, şuna bak. 
vi	Tôi có vị trí rồi. Steve, nhìn này. 
zh-long	我查到地點了，史蒂夫，你看 
zh-short	我拿到地址了 史蒂夫 看这个 
ja	&lrm;スティーヴ　見ろ | 

