en	-[EKG machine beeping] | -[wheezing] | 

el	Κλείδωσε τις πόρτες! 
ar	‫أغلقي الأبواب! تأكدي من ألا تفتحيها!‬ | 
cs	Zamkni dveře! Ať je nikdo neodemyká! 
da	Lås dørene! Hold dem lukket! 
de	Verriegel die Türen! Mach sie ja nicht auf! 
en	Lock your doors! Make sure you don't open them! 
es-eu	¡Cierra bien la puerta! No la abras por nada. 
es	Traba las puertas, no abras por nada. 
fi	Lukitse ovet! Älä avaa niitä missään nimessä! 
fr	Verrouille tes portes ! N'ouvre à personne ! 
he	‫תנעלי את הדלתות!‬ | ‫אל תפתחי אותן בשום מצב!‬ | 
hr	Zaključaj vrata i nikome ne otvaraj! 
it	Chiudi le porte a chiave! Vedi di non aprirle. 
ja	&lrm;鍵をかけろ | &lrm;ドアを開けるな！ | 
ko	문 잠그고 있어 절대 열어주면 안 돼! 
ms	Kunci pintu rumah! Jangan buka untuk sesiapa! 
nl	Doe de deuren op slot en doe ze niet open. 
no	Lås dørene! Du må ikke åpne dem! 
pl	Zamknij drzwi! Nikomu nie otwieraj! 
pt-br	Tranque as portas e não abra! 
pt	Tranca as portas! Certifica-te de que não as abres! 
ro	Încuie ușa! Nu deschide nimănui! 
sv	Lås dörrarna! Se till att inte öppna dem! 
th	ล็อกประตู! อย่าเปิดประตูเด็ดขาด! 
tr	Kapıları kilitle. Sakın açma! 
vi	Khóa cửa lại! Dù thế nào cũng đừng mở! 
zh-long	把門鎖上，千萬別打開！ 
zh-short	锁好门！千万不要开门！ 
hu	Zárkózz be! Ne nyiss ajtót senkinek! 
id	Kunci pintu! Pastikan jangan dibuka! | 
ru	Запри двери! Никому не открывай! 
el	Μην ανοίξεις! 

