en	[Peter whimpers] | 

no	Pass på barna dine. 
ar	‫اهتمي بأطفالك! سأسرق قاربًا!‬ | 
cs	Postarej se o děti. Jdu ukrást loď! 
da	Beskyt dine børn. Jeg stjæler en båd! 
de	Pass auf deine Kinder auf! Ich klaue ein Boot! 
el	Φρόντισε τα παιδιά σου! Θα κλέψω ένα σκάφος! 
en	Take care of your children! I'm gonna steal a boat! 
es	Cuida a tus hijos. ¡Yo voy a robar una lancha! 
es-eu	¡Cuida de tus hijos! ¡Voy a robar un barco! 
fi	Pidä huolta lapsistasi! Aion varastaa veneen! 
fr	Prends soin de tes enfants ! Je vais voler un bateau ! 
he	‫שמרי על הילדים שלך!‬ | ‫אני הולך לגנוב סירה!‬ | 
hr	Čuvaj svoju djecu! Ukrast ću čamac! 
it	Pensa ai tuoi figli! Vado a rubare una barca. 
ja	&lrm;気をつけて　僕は船を盗む | 
ko	애들 잘 돌보고 있어 난 배 좀 훔쳐야겠어! 
ms	Pastikan anak-anak selamat! Saya nak curi bot! 
nl	Zorg voor je kinderen. Ik ga een boot stelen. 
pl	Zajmij się dziećmi! Ukradnę łódź! 
pt-br	Cuide dos seus filhos! Vou roubar um barco! 
pt	Cuida dos teus filhos! Vou roubar um barco! 
ro	Ai grijă de copii! O să fur o barcă! 
sv	Ta hand om dina barn! Jag ska stjäla en båt! 
th	ดูแลลูกๆ คุณด้วย ผมจะขโมยเรือไป 
tr	Çocuklarına iyi bak. Ben bir tekne çalacağım. 
vi	Chăm sóc các con đi! Tớ sẽ trộm thuyền! 
zh-long	照顧妳的孩子，我要去偷一艘船！ 
zh-short	照顾好你的孩子们！ 我要去偷一艘船！ 
hu	Vigyázz a gyerekeidre! Elkötök egy hajót! 
id	Jaga anak-anakmu! | Aku akan mencuri kapal! | 
ru	Позаботься о детях! Я угоню катер! 
no	Jeg stjeler en båt! 

