en	-[static crackles] | -[yells] | 

ar	‫أنت بخير.‬ | 
cs	Jsi v pořádku. 
da	Du er okay. 
en	You're okay. 
es-eu	Estás bien. 
fi	Olet kunnossa. 
fr	Tu vas bien. 
he	‫את בסדר.‬ | 
hr	Dobro si. 
hu	Jól vagy. 
it	Stai bene. 
ko	무사하시네요 
ms	Ibu tak apa-apa. 
nl	Je bent in orde. 
pt	Estás bem. 
sv	Du är oskadd. 
th	แม่ปลอดภัยดี 
tr	İyisin. 
vi	Mẹ không sao. 
zh-long	妳沒事 
zh-short	你没事 
pt-br	Você está bem. 
ru	С тобой всё хорошо. 
ja	&lrm;無事だね | 
es	Estás bien. 
de	Dir geht's ok. 
no	Det går bra med deg? 
pl	Nic ci nie jest. 
el	Είσαι καλά. 
id	Ibu tak apa. | 
ro	Ești bine. 

