en	[Peter groans] | 

id	Tidak. | 
es	Ay, no. 
ar	‫لا.‬ | 
cs	Ale ne. 
da	Åh nej. 
de	Oh nein. 
el	Όχι. 
en	Oh, no. 
es-eu	No… 
fi	Voi ei. 
fr	Oh, non. 
he	‫אוי, לא.‬ | 
hr	O, ne. 
hu	Jaj, ne! 
it	Oh, no. 
ko	안 돼 
nl	O, nee. 
no	Å nei. 
pl	O nie. 
pt-br	Ah, não. 
pt	Não. 
ro	Nu. 
ru	О нет. 
sv	Åh, nej. 
th	ไม่นะ 
tr	Olamaz. 
vi	Ôi không. 
zh-long	糟糕 
zh-short	不是吧 
ms	Alamak! 
ja	&lrm;まさか | 

