en	[reporters clamoring] | 

es	¿soy alguien especial para ti, mamá? 
ar	‫أأنا شخص مميز لديك يا أمي؟‬ | 
cs	Já jsem ten tvůj výjimečný, mami? 
da	Er jeg din helt særlige person, mor? 
de	Bin ich dein besonderer Mensch, Mom? 
el	είμαι ο κάποιος ξεχωριστός, μαμά; 
en	Am I your special someone, Mom? 
es-eu	¿Soy tu alguien especial, mamá? 
fi	Olenko sinun rakkaimpasi, äiti? 
fr	Je suis quelqu'un de spécial pour toi, maman ? 
he	‫אני המישהו המיוחד שלך, אמא?‬ | 
hr	Jesam li ja tvoja draga osoba, mama? 
hu	Anya, én vagyok a különleges valaki? 
id	Apa aku orang spesialmu, Ibu? | 
it	Sono la tua persona speciale, mamma? 
ja	&lrm;僕は母さんの特別な人？ | 
ko	제가 엄마의 특별한 사람인가요? 
ms	adakah saya orang istimewa ibu? 
nl	Ben ik jouw speciale iemand, mam? 
no	Er det meg du har kjær, mamma? 
pl	Jestem dla ciebie kimś wyjątkowym, mamo? 
pt-br	eu sou sua pessoa especial, mãe? 
pt	… sou a tua pessoa especial, mãe? 
ru	…я твой особенный человек, мама? 
sv	…är jag din speciella person? 
th	ผมคือคนพิเศษของแม่เหรอ 
tr	Ben senin için özel miyim anne? 
vi	Con là người đặc biệt của mẹ ạ? 
zh-long	媽，我是妳生命中最特別的人嗎？ 
zh-short	我是你的特别之人 妈妈？ 
ro	Eu sunt o persoană specială pentru tine, mamă? 

