en	-[yelling] | -[bell dings] | 

vi	Cháu luôn bị áp lực lúc nào cũng phải ngầu. 
ar	‫أشعر بضغط كبير لأكون هادئًا طوال الوقت.‬ | 
cs	Cítím velký tlak, abych byl za frajera. 
da	Jeg føler et pres for  hele tiden at være cool. 
en	I feel a lot of pressure to be cool all the time. 
es-eu	Siento mucha presión por ser guay. 
fi	Minulla on paineita olla cool koko ajan. 
fr	J'ai beaucoup de pression d'être cool tout le temps. 
he	‫אני מרגיש שיש עליי הרבה לחץ‬ | ‫להיות מגניב כל הזמן.‬ | 
hu	Nagy a nyomás, hogy mindig menő legyek. 
it	Io sento la pressione di essere sempre fico. 
nl	Ik voel de druk om altijd cool te zijn. 
pl	Czuję dużą presję, żeby być fajnym. 
pt	Sinto muita pressão em ser sempre fixe. 
th	ผมรู้สึกกดดันมากที่จะทำตัวเยี่ยมๆ อยู่ตลอดเวลา 
tr	Sürekli havalı olma baskısı altındayım. 
zh-short	我耍帅总是感觉有很多压力 
sv	Jag känner press att vara cool hela tiden. 
ko	전 늘 멋져 보여야 한다는 압박감을 느껴요 
ms	Saya tertekan untuk sentiasa kekal hebat. 
zh-long	我必須一直裝酷，壓力很大 
el	Νιώθω μεγάλη πίεση για να είμαι κουλ. 
hr	Pod velikim sam pritiskom da stalno budem kul. 
de	Ich spüre großen Druck, immer cool zu sein. 
pt-br	Sinto muita pressão para ser maneiro o tempo todo. 
ru	Чтобы быть всегда крутым, мне нельзя расслабляться. 
es	Siento mucha presión por ser genial todo el tiempo. 
no	Jeg kjenner på et press om å være kul. Jeg misunner Hubie som bare er seg selv. 
ja	&lrm;確かに いつも自分らしい | &lrm;ヒュービーが羨ましかった | 
id	Aku tertekan untuk selalu menjadi keren. | 
ro	Simt multă presiune să fiu mereu mișto. 

