en	Yeah! [grunting] | 

ar	‫أشعر بالغيرة من "هوبي"‬ | ‫لأنه قادر على التصرف على طبيعته.‬ | 
es	Me da celos que Hubie pueda mostrarse como es. 
el	Ζηλεύω που ο Χιούμπι είναι ο εαυτός του. 
hr	Ljubomoran sam što Hubie može biti svoj. 
pt	Tenho inveja de o Hubie ser ele próprio. 
ms	Saya cemburu Hubie boleh jadi diri sendiri. 
nl	Ik ben jaloers omdat hij zichzelf kan zijn. 
de	Ich beneide Hubie, weil er zu sich steht. 
cs	Závidím Hubiemu, že umí být sám sebou. 
da	Jeg er misundelig over, at Hubie er sig selv. 
en	I'm jealous of Hubie being able to be himself. 
fr	Je suis jaloux que Hubie puisse être lui-même. 
he	‫אני מקנא ביובי‬ | ‫על זה שהוא מסוגל להיות עצמו.‬ | 
hu	Féltékeny vagyok Hubie-ra, mert önmaga lehet. 
id	Aku iri karena dia bisa jadi diri sendiri. | 
it	Sono invidioso perché Hubie è se stesso. 
ko	자기 모습 그대로 보여주는 휴비가 부러웠어요 
pl	Zazdroszczę, że Hubie umie być sobą. 
th	ผมอิจฉาฮิวบี้ที่เป็นตัวของตัวเองได้ 
vi	Cháu ghen với việc Hubie có thể là chính mình. 
zh-long	我很嫉妒修比能夠做自己 
zh-short	我嫉妒修比能够做自己 
fi	Olen kateellinen, koska Hubie on oma itsensä. 
tr	Hubie'yi kendisi olabildiği için kıskanıyorum. 
ro	Sunt gelos că Hubie poate fi el însuși. 
es-eu	Me da envidia que Hubie  pueda ser él mismo. 
sv	Jag är avundsjuk på att Hubie kan vara sig själv. 
pt-br	Tenho inveja de o Hubie poder ser ele mesmo. 
ru	Завидую Хьюби. Он может быть самим собой. 

