en	Yeah! | 

es	¿Por qué alguien como Hubie tiene una cabellera tan abundante 
ja	&lrm;ヒュービーは | &lrm;髪がフサフサなのに&lrm;― | 
ar	‫لم يجب أن يملك شخص مثل "هوبي"‬ | ‫شعرًا فخمًا وكثيفًا كهذا،‬ | 
cs	Proč by někdo jako Hubie měl mít takhle hustou, luxusní kštici, 
da	Hvorfor skal en som Hubie have sådan en tyk, fyldig hårpragt, 
de	Warum sollte jemand wie Hubie eine so dicke, üppige Haarpracht haben, 
en	Why should someone like Hubie have such a thick, luxuriant head of hair, 
es-eu	¿Por qué alguien como Hubie tiene un cabello tan espeso y exuberante 
fi	Miksi jollakin Hubien kaltaisella on niin paksu, elinvoimainen tukka, 
fr	Pourquoi un type comme lui aurait des cheveux aussi épais et luxuriants, 
he	‫למה שלמישהו כמו יובי‬ | ‫תהיה רעמת שיער כזאת סמיכה ושופעת,‬ | 
hr	Zašto bi netko poput Hubieja imao bujnu, raskošnu kosu, 
hu	Miért van egy Hubie-félének ilyen dús, egészséges haja, 
it	Perché uno come Hubie ha una chioma così folta e rigogliosa, 
ko	휴비는 저렇게 모발도 굵고 머리숱도 많은데 
ms	Kenapa orang macam Hubie miliki rambut tebal 
nl	Waarom heeft Hubie zo'n mooie, weelderige haarbos… 
no	Hvorfor skal en som Hubie ha en fyldig manke, 
pl	Dlaczego ktoś taki jak Hubie ma taką gęstą, bujną czuprynę, 
pt	Porque haveria alguém como o Hubie de ter um cabelo tão espesso e exuberante 
ro	De ce cineva ca Hubie are un păr atât de gros și de epatant, 
ru	Почему у такого, как Хьюби, густая, пышная шевелюра, 
sv	Varför ska nån som Hubie ha sånt tjockt och fint hår  
th	ทำไมคนอย่างฮิวบี้ถึงผมดกหนาเต็มหัว 
tr	Hubie gibi birinin böyle kalın, güzel saçları varken ben niye 
vi	Tại sao một kẻ như Hubie lại có mái tóc dày và đẹp đẽ thế, 
zh-long	為什麼修比這樣的人 有這麼濃密的一頭秀髮 
zh-short	修比这个人为什么 有那么浓密、茂盛的头发？ 
pt-br	Por que alguém como o Hubie tem uma cabeleira tão exuberante 
el	Γιατί κάποιος σαν τον Χιούμπι να έχει τόσο πυκνά, πλούσια μαλλιά 
id	Kenapa orang seperti Hubie punya | rambut tebal dan mewah, | 

