id	Ayo! 

ja	&lrm;なぜ俺は | &lrm;レーズンみたいな頭だと | 
ar	‫وأنا أبدو مثل زبيب "كاليفورنيا"؟‬ | 
cs	když já mám hlavu jako lampión? 
da	når jeg ligner en rosin? 
de	und ich sehe aus wie eine kalifornische Rosine? 
el	κι εγώ να είμαι σαν σταφίδα Καλιφόρνιας; 
en	and I look like a California raisin? 
es-eu	y yo parezco una pasa de California? 
es	y yo parezco una pasa con patas? 
fi	ja minä näytän rusinalta? 
fr	alors que je ressemble à un raisin de Californie ? 
he	‫ואני נראה כמו צימוק?‬ | 
hr	kad ja izgledam kao lik iz  Graškograda ? 
hu	én meg nézek ki úgy, mint Kojak? 
id	sementara aku seperti kismis California? | 
it	mentre io sembro un'uvetta della California? 
ko	난 왜 캘리포니아 건포도 꼴인지 
ms	sedangkan saya nampak macam kismis California. 
nl	…en zie ik eruit als een rozijn? 
no	mens jeg ser ut som en rosin? 
pl	a ja wyglądam jak rodzynka z Kalifornii? 
pt	e eu parecer uma passa da Califórnia? 
ro	iar eu arăt ca o stafidă californiană? 
ru	а я похож на калифорнийский изюм? 
sv	medan jag ser ut som ett russin? 
th	แต่ผมดูเหมือนลูกเกดแคลิฟอร์เนีย 
tr	Kaliforniya kuru üzümüne benziyorum? 
vi	còn tôi trông như hạt nho khô California? 
zh-long	我看起來卻像加州葡萄乾？ 
zh-short	而我看着像个加州葡萄干？ 
pt-br	e eu pareço uma uva passa da Califórnia? 

