en	-I'm gonna make 'em go night-night. | -[laughs] | 
ja	奴をねんねさせる | 
id	Akan kubuat mereka tidur. 

ar	‫تبًا له ولأمله!‬ | 
cs	S čertu s ním a jeho nadějí! 
da	Fanden tage ham og hans håb. 
en	Damn him and his hope! 
fr	Maudit soit-il avec son espoir ! 
he	‫לעזאזל איתו ועם התקווה שלו!‬ | 
hu	A fene belé és a reményébe! 
it	Maledetto lui e la speranza! 
sv	Fan ta honom och hans hopp! 
th	เขากับความหวังของเขา 
vi	Hắn và hy vọng chết tiệt! 
zh-short	他和他的希望去死吧！ 
nl	Ik vervloek hem en zijn hoop. 
hr	Proklet bio on i njegova nada! 
ms	Saya benci harapan itu! 
de	Verflucht sei seine Hoffnung! 
no	Faen ta ham og håpet hans! 
pt	Maldito seja ele e a sua esperança! 
es-eu	¡Malditos sean él y su esperanza! 
es	¡Malditos sean él y su esperanza! 
fi	Hän ja hänen kirottu toivonsa! 
ja	&lrm;その希望が妬ましいわ | 
pl	Niech szlag trafi jego i tę nadzieję! 
tr	Ona da umuduna da lanet olsun! 
zh-long	去你的狗屁希望！ 
id	Terkutuk dia dan harapannya! | 
pt-br	Maldito seja ele e sua esperança! 
ru	Будь он проклят со своей надеждой! 
ko	넌 희망 있어서 좋겠다! 
el	Ανάθεμα αυτόν και την ελπίδα του! 
ro	La naiba cu el și cu speranța lui! 

