ja	喜んで | 

es	Mi cuñado me dijo una vez que yo no tenía ambiciones. 
hr	Moj je šogor jedanput rekao da nemam ambicije. 
no	Svogeren min sa at jeg manglet ambisjoner. 
de	Mein Schwager sagte mal, ich hätte keinen Ehrgeiz. 
ms	Abang ipar saya pernah kata saya tiada cita-cita. 
ru	Мой шурин сказал, что у меня нет амбиций. 
fi	Lankoni sanoi kerran, ettei minulla ole kunnianhimoa. 
pt-br	Meu cunhado uma vez me disse que eu não tinha ambições. 
ar	‫قال زوج أختي ذات مرة إنني لست طموحًا.‬ | 
cs	Můj švagr kdysi řekl, že nemám ambice. 
da	Min svoger har sagt, jeg intet mål havde. 
en	My brother-in-law once said that I had no ambition. 
fr	Mon beau-frère a dit que je n'avais aucune ambition. 
he	‫גיסי פעם אמר שאין לי שאיפות.‬ | 
hu	A sógorom azt mondta, nincsenek ambícióim. 
id	Iparku pernah bilang aku tak punya ambisi. | 
ko	매형이 내게 그러더군요 넌 너무 야망이 없다고 
ro	Cumnatul meu mi-a spus că nu am ambiție. 
sv	Min svåger sa att jag saknar ambitioner. 
th	พี่เขยผมเคยพูดว่าผมไม่มีความทะเยอทะยาน 
tr	Kayınbiraderim bana hırsım olmadığını söylemişti. 
vi	Anh rể tôi từng nói tôi không có tham vọng. 
zh-short	我姐夫有一次说 我没有野心 
el	Ο κουνιάδος μου είπε ότι δεν είχα φιλοδοξία. 
pl	Mój szwagier powiedział, że nie mam ambicji. 
es-eu	Mi cuñado dijo una vez que no tenía ambición. 
nl	Mijn zwager zei ooit dat ik geen ambitie had. 
pt	O meu cunhado disse uma vez que não tinha ambição. 
it	Mio cognato una volta disse che non avevo ambizioni. 
ja	&lrm;野望に欠けてると | &lrm;義兄に言われた | 
zh-long	我姊夫有一次說我沒有野心 

