ru	Перестаньте! Только не это. 
fr	Couché ! Soyez gentils. 
ja	来るな！ やめてくれ | 
id	Ayolah! Jangan... Kumohon. 

de	Hubie-Schnuffilein. 
id	Hubie, jadilah milikku. | 
ar	‫كن لي يا "هوبي".‬ | 
cs	Hubie, buď jen můj. 
da	Hubie, du' min. 
el	Χιούμπι, γίνε δικός μου. 
en	Hubie, do be mine. 
es-eu	Hubiedubi, sé mío. 
es	Hubie, sé mío. 
fi	Hubie, ole minun beibi. 
fr	Hubie, sois mien. 
he	‫יובי, בובי שלי.‬ | 
hr	Hubie, daj me poljubi. 
hu	Hubie, szupi vagy! 
it	Hubie, tu mi tubi. 
ja	&lrm;ヒュービー　抱いて | 
ko	휴비 듀비, 내 남자 
ms	Hubie, jadilah milik saya. 
nl	Hubie, wees de mijne. 
no	Hubie, du blir min. 
pl	Hubie, bądź mój. 
pt-br	Hubie, tome meu amor. 
pt	Hubie, sê meu. 
ro	Hubie, fii al meu! 
ru	Хьюби, будь моим. 
sv	Hubie, bli min. 
th	ฮิวบี้ ที่รักของฉัน 
tr	Hubie, benimsin. 
vi	Hubie, hãy là của em. 
zh-long	修比杜比，你是我的 
zh-short	修比 做我的男人 

