id	- Mau lakukan apa? - Melatih kakimu itu. 
ja	何？ | 

ru	Нет! 
ar	‫لا!‬ | 
cs	Ne! 
da	Nej! 
de	Nein! 
el	Όχι! 
en	No! 
es-eu	¡No! 
fi	Ei! 
fr	Non ! 
he	‫לא!‬ | 
hr	Ne! 
hu	Ne! 
id	Tidak! | 
it	No! 
ko	안 돼! 
ms	Tidak! 
nl	Nee. 
no	Nei! 
pl	Nie! 
pt-br	Não! 
pt	Não! 
ro	Nu! 
sv	Nej! 
th	ไม่! 
tr	Hayır! 
vi	Không! 
zh-long	不要！ 
zh-short	不！ 
es	¡No! 

