en	[crowd groans] | 

ar	‫انصرف…‬ | 
cs	Dohněda… 
da	Lugt... 
de	Riechen Sie… 
el	Μύρισε… 
en	Smell-- 
es-eu	Huéleme… 
es	Huele… 
fi	Haista… 
fr	Sens… 
he	‫תריח…‬ | 
hr	Pomiriši... 
hu	Szagolj… 
id	Angkat… | 
it	Annusami… 
ko	발 냄새 
nl	Ruik… 
no	Kyss… 
pl	Musisz… 
pt	Vai… 
ro	Miroase-mi… 
sv	Ta… 
th	ไส... 
tr	Ayaklarımı... 
vi	Xéo... 
zh-long	來聞… 
zh-short	请你… 
ru	Понюхай… 
en	Shmell... 

