da	Den bedste 
en	-♪ The best ♪ | -[actors quacking] | 
ru	Лучше 

uk	Кожна дитина вважає, що батьки зіпсували їй життя. 
da	Alle unge mener, | deres forældre ødelægger deres liv. | 
el	Κάθε παιδί νομίζει ότι οι γονείς του το κατέστρεψαν. 
en	Every kid thinks their parents screwed up their life. 
fr	Tous les ados en veulent à leurs parents. 
he	‫כל ילד חושב שההורים שלו דפקו לו את החיים.‬ | 
hr	Svaki klinac misli da su mu roditelji sjebali život. 
ja	&lrm;どの子も親のせいにする | 
ko	&lrm;애들은 다 부모가 제 인생을 | &lrm;망쳤다고 생각하잖아 | 
ms	Semua budak fikir ibu bapa merosakkan hidup mereka. 
no	Alle barn tror foreldrene ødelegger livet. 
ro	Toți copiii cred că părinții le-au distrus viața. 
sv	Alla barn tycker att ens föräldrar förstör ens liv. 
th	&lrm;ลูกทุกคนคิดว่าพ่อแม่ทำชีวิตลูกๆ พังทั้งนั้น | 
tr	Her çocuk ebeveyni hayatını mahvediyor diye düşünür. 
vi	&lrm;Đứa trẻ nào cũng nghĩ | &lrm;cuộc sống của mình bị bố mẹ kìm kẹp. | 
zh-long	每個孩子都覺得父母毀了他們的人生 
zh-short	每个孩子都认为 父母毁掉了自己的人生 
cs	Každý dítě si myslí, že mu rodiče posrali život. 
es-eu	Todos los chicos creen que sus padres los han jodido. 
fi	Kaikkien nuorten mielestä | vanhemmat pilasivat heidät. | 
pt-br	Todo adolescente acha que os pais arruinaram sua vida. 
ru	Каждый ребенок считает, что родители портят ему жизнь. 
id	Setiap anak mengira orang tuanya mengacaukan hidupnya. 
nl	Ieder kind vindt dat hun ouders ze het leven zuur maken. 
es	Todos los niños creen que sus padres les arruinaron la vida. 
hu	Minden gyerek azt hiszi, hogy a szülei kúrják el az életét. 
pt	Os miúdos acham sempre que os pais lhes dão cabo da vida. 
it	Ogni figlio pensa che i genitori gli abbiano rovinato la vita. 

