en	[blowing] | 

it	le importerebbe di se stessa, no? 
nl	Ze geeft toch wel om zichzelf? 
ms	takkan dia tak sayang dirinya? 
es-eu	cuidaría su salud, ¿no? 
hr	za sebe bi valjda marila. 
id	dia akan memedulikan dirinya, 'kan? 
pt-br	se importaria com ela mesma, não? 
da	ville hun vel passe på sig selv? | 
el	θα νοιαζόταν για τον εαυτό της. 
fr	elle tient à sa vie, non ? 
he	‫עדיין יהיה אכפת לה מעצמה, נכון?‬ | 
hu	magával csak törődne. 
ko	&lrm;본인 몸은 챙길 거 아닙니까? | 
pt	preocupa-se com ela mesma, não? 
ro	de ea însăși tot îi pasă, nu? 
th	&lrm;เธอก็ต้องเป็นห่วงตัวเองบ้าง | 
tr	kendisini umursardı, değil mi? 
vi	&lrm;thì cô ấy cũng quan tâm đến bản thân chứ? | 
zh-long	她至少也要在乎自己吧？ 
zh-short	她总该关心她自己吧？ 
es	se preocuparía por sí misma, ¿no? 
sv	så bryr hon väl sig om sig själv? 
no	ville hun vel bry seg om seg selv? 
ja	&lrm;自己本位な女ではない | 
fi	hän välittäisi itsestään. | 
uk	але ж не на саму себе? 
cs	na sebe by asi nekašlala. 
ru	она бы озаботилась о себе. 
en	she'd care about herself, wouldn't she? 

en	♪ He did the mash ♪ 

