en	-[door alarm buzzing] | -[indistinct announcement over PA] | 

ar	‫"أعرفت يومًا أنك بطلي؟‬ | 
cs	Víš o tom, že jsi můj hrdina? 
da	Vidste du, at du er min helt? 
de	War dir klar, dass du mein Held bist? 
el	Ήξερες ότι είσαι ο ήρωάς μου; 
en	♪ Did you ever know That you're my hero? ♪ 
es-eu	¿Sabías que eres mi héroe? 
fi	Tiesitkö, että olet sankarini? 
fr	As-tu jamais su que tu es mon héros ? 
he	‫"האם ידעת שאתה הגיבור שלי?‬ | 
hr	Jesi li znao da moj si junak ? 
hu	Tudtad-e valaha, hogy te vagy a hősöm   ? 
it	Hai mai saputo che sei il mio eroe? 
ko	당신은 나의 영웅이란 걸 아나요? 
ms	Adakah kau tahu kau wiraku? 
nl	wist je dat je mijn held bent? 
no	Visste du at du er min helt? 
pl	Czy wiedziałeś, że jesteś moim bohaterem? 
pt	Alguma vez soubeste que és o meu herói? 
pt-br	Você sabia que é meu herói? 
ro	Ai știut vreodată că ești eroul meu? 
ru	Знал ли ты, что ты мой герой? 
sv	Visste du att du var min hjälte? 
th	คุณเคยรู้หรือไม่ว่าคุณคือฮีโร่ของฉัน 
tr	Kahramanım olduğunu biliyor muydun? 
vi	Cha có bao giờ biết cha là anh hùng của con? 
zh-long	你可知你是我心裡的英雄？ 
zh-short	你是否知道 你是我的英雄？ 
id	Apa kau tahu kau pahlawanku? | 
es	¿Supiste alguna vez que eres mi héroe? 
ja	&lrm;あなたは | &lrm;　　私の英雄だったのよ | 

