en	[sighs] | 

en	Ah! The dead speak! 
vi	Người chết lên tiếng. 
es	Los muertos hablan. 
ms	Orang mati bercakap. 
ar	‫تحدث الميت.‬ | 
cs	Mrtvý promluvil. 
da	De døde taler. 
el	Οι νεκροί μιλάνε. 
es-eu	Los muertos hablan. 
fi	Kuolleet puhuvat. 
fr	Le mort parle. 
he	‫המתים מדברים.‬ | 
hr	Mrtvi govore. 
hu	A holtak beszélnek. 
it	I morti parlano. 
ko	시체가 말을 하네 
nl	De doden spreken. 
pl	Umarły przemówił. 
pt-br	Os mortos falam. 
pt	Os mortos falam. 
ro	Morții vorbesc. 
ru	Мертвец говорит. 
sv	De döda talar. 
th	คนตายพูดได้ 
tr	Ölü konuşuyor. 
zh-long	死人講話了 
zh-short	死人说话了 
de	Die Toten sprechen. 
id	Yang mati berbicara. | 
no	De døde snakker. 
ja	&lrm;死人が話した… | 

