en	I thought you called him. | 
ja	君はかけた？ | 

de	Nun, ihr könnt es mir glauben: nett zu sein ist wichtig. 
ja	&lrm;優しいって大切なことなのよ | 
es	Bueno, créanme. 
ar	‫تعلموا هذا مني. اللطف مهم.‬ | 
cs	Věřte mi, že tahle vlastnost je důležitá. 
da	Hej, tro mig. Sød betyder noget. 
en	Well, take it from me. Nice matters. 
es-eu	Y, hacedme caso, eso es muy importante. 
fi	No, uskokaa pois. Mukavuudella on väliä. 
fr	Eh bien, croyez-moi. Être gentil, ça compte. 
he	‫טוב, תאמין לי. חשוב להיות נחמד.‬ | 
hr	Pa vjerujte mi. Dobrota je važna. 
hu	Hát, nekem elhiheted. A kedvesség fontos. 
it	Beh, credetemi. La gentilezza conta. 
ms	Percayalah, baik itu penting. 
nl	Aardig zijn is belangrijk. 
no	Vel, stol på meg, det å være snill er viktig. 
pl	Słuchajcie uważnie. Bycie miłym jest ważne. 
pt	Bem, acreditem, a simpatia importa. 
pt-br	Bem, confie em mim. Ser legal importa. 
ro	Vă spun eu, e important să fii de treabă. 
ru	Поверь мне. Доброта многое значит. 
sv	Lita på mig. Snällhet spelar roll. 
th	เชื่อแม่สิ นิสัยดีเป็นสิ่งสำคัญ 
tr	Benden duyun. Nezaket önemlidir. 
vi	Chà, nghe lời mẹ đi. Tử tế quan trọng lắm. 
zh-long	聽媽的話，心地善良很重要 
zh-short	相信我 善良非常重要 
el	Πίστεψέ με. 
id	Percayalah. Baik itu penting. | 
ko	잘 새겨들어 좋은 사람이란 중요한 거야 
es	Es importante ser bueno. 
el	Η καλοσύνη μετράει. 

