en	No, I'm not. | 
id	Tidak. 
ru	Нет. 
ja	まさか | 

es	Llegó la noche más aterradora del año, niños. 
ar	‫حلت أكثر ليلة مخيفة في العام يا أطفال.‬ | 
cs	Nejděsivější večer roku je tady, děti. 
da	Årets mest uhyggelige aften er nu. 
es-eu	Ha llegado la noche más aterradora del año. 
fi	Vuoden pelottavin ilta on saapunut, lapsoset. 
fr	La nuit la plus effrayante de l'année est là, les enfants. 
he	‫הלילה הכי מפחיד בשנה הגיע, ילדודס.‬ | 
it	La notte più spaventosa dell'anno è arrivata. 
ko	일 년 중 가장 무시무시한 밤이 돌아왔네요, 어린이 여러분 
nl	De engste nacht van het jaar is aangebroken. 
sv	Årets läskigaste kväll är här, ungar. 
th	คืนที่น่ากลัวที่สุดแห่งปีมาถึงแล้ว เด็กๆ 
tr	Yılın en korkunç gecesi geldi çocuklar. 
vi	Đêm đáng sợ nhất năm đã đến rồi mấy nhóc. 
zh-long	各位小朋友，全年最可怕的一晚來了 
zh-short	孩子们 一年中最恐怖的夜晚来了 
ms	Malam paling menakutkan telah tiba, anak-anak. 
hr	Najstrašnija noć u godini stigla je, dječice. 
el	Η πιο τρομακτική νύχτα της χρονιάς έφτασε. 
pt-br	A noite mais assustadora do ano chegou, crianças. 
pt	Chegou a noite mais assustadora do ano, miúdos. 
de	Die gruseligste Nacht des Jahres steht an. 
hu	Elérkezett az év legijesztőbb éjszakája, gyerekek. 
ja	&lrm;恐怖の夜がやってきたわ | 
ja	〝ハッピー･ | 　ハロウィンナー(ペニス)〞 | 
ro	Copii, a venit cea mai înfricoșătoare noapte din an. 
id	Malam paling menakutkan tahun ini | telah tiba, Anak-anak. | 
ru	Пришла самая страшная ночь в году. 
pl	Nadeszła najstraszniejsza noc w roku. 
no	Vi er fremme ved årets skumleste kveld, barn. 
en	[Aurora]  The scariest night of the year has arrived, kiddies. 

