ja	どこが？ | 

es	Habrá luna llena, y los monstruos andarán sueltos. 
ja	&lrm;満月になり | &lrm;怪物たちが姿を現す | 
hr	Bit će pun mjesec, pa će čudovišta biti vani. 
ar	‫سيكون القمر بدرًا، لذا ستخرج الوحوش.‬ | 
cs	Bude úplněk, takže vylezou všechny příšery. 
da	Der bliver fuldmåne, og monstrene kommer ud. 
de	Heute ist Vollmond angesagt, die Monster kommen also raus. 
el	Θα έχει πανσέληνο, οπότε τα τέρατα θα βγουν έξω. 
en	It's gonna be a full moon, so the monsters will be out. 
es-eu	Habrá luna llena, así que los monstruos se manifestarán. 
fi	Nyt on täysikuu, joten hirviöt ovat liikkeellä. 
fr	Ce sera la pleine lune, les monstres seront de sortie. 
he	‫הולך להיות ירח מלא,‬ | ‫אז המפלצות יסתובבו בחוץ.‬ | 
hu	Telihold lesz, a szörnyek elő fognak jönni. 
id	Bulan purnama akan muncul, | jadi, para monster akan keluar. | 
it	Ci sarà la luna piena, quindi i mostri usciranno. 
ko	보름달이 뜰 예정이라니 괴물들이 출몰하겠군요 
ms	Bulan akan mengambang penuh, raksasa akan keluar. 
nl	We krijgen een volle maan, dus de monsters zijn op jacht. 
no	Det blir fullmåne, så uhyrene vil komme frem. 
pl	Będzie pełnia, więc pojawią się potwory. 
pt-br	Será noite de lua cheia, então os monstros vão sair. 
pt	Vai estar lua cheia, por isso os monstros vão sair. 
ro	Va fi lună plină, deci monștrii vor ieși. 
ru	Будет полнолуние, и нечисть выйдет на охоту. 
sv	Det kommer att vara fullmåne, så monstren kommer att vara ute. 
th	ดวงจันทร์จะเต็มดวง อสุรกายจะปรากฏตัว 
tr	Dolunay olacak. Yani, canavarlar yuvasından çıkacak. 
vi	Sẽ là một đêm trăng tròn, nên lũ quái vật sẽ mò ra. 
zh-long	今天是滿月，所以怪獸會跑出來喔 
zh-short	今晚会是满月 所以怪物会跑出来 

