en	[clears throat] | 

es	¿Qué? 
ar	‫ماذا؟‬ | 
cs	Cože? 
da	Hvad? 
de	Was? 
el	Ορίστε; 
en	What? 
es-eu	¿Qué? 
fi	Mitä? 
fr	Quoi ? 
he	‫מה?‬ | 
hr	Molim? 
hu	Mi? 
id	Apa? | 
it	Cosa? 
ja	&lrm;何？ | 
ko	뭐? 
ms	Apa? 
nl	Wat? 
no	Hva? 
pl	Słucham? 
pt-br	O quê? 
pt	O quê? 
ru	Что? 
sv	Va? 
th	อะไรนะ 
tr	Ne? 
vi	Sao? 
zh-long	什麼？ 
zh-short	什么？ 
ro	Poftim? 

