en	[indistinct] | 

ar	‫"الأشباح والغيلان مخيفة جدًا‬ | 
cs	Duchové a skřeti vyděsí tě natošup 
da	Spøgelser og trolde, de skræmmer dig 
de	Geister und Kobolde sind unheimlich 
el	Φαντάσματα και τελώνια τρομακτικά πολύ 
en	♪ Ghosts and goblins very scary  ♪ 
es-eu	Los fantasmas y los duendes dan mucho miedo 
es	Veo fantasmas a menudo. 
fi	Aaveita ja peikkoja kaikki pelkää 
fr	Fantômes et gobelins monstrueux 
he	‫"רוחות רפאים וגובלינים, מאוד מפחיד‬ | 
hr	Duhovi i goblini, totalna strava 
hu	A szellemek és koboldok ijesztőek, 
id	Hantu dan goblin sangat menakutkan | 
it	Fantasmi e goblin spaventosi 
ja	&lrm;幽霊と怪物に気をつけろ | 
ko	고스트와 고블린은 무시무시하지 
ms	Hantu dan goblin amat menakutkan 
nl	geesten en goblins zijn erg naar 
no	Spøkelser og troll, skremmer deg 
pl	Duchy i gobliny straszne są  
pt-br	Fantasmas e duendes dão muito medo 
pt	Fantasmas e duendes muito assustadores 
ro	Fantomele și goblinii arată fioros 
ru	Призраки и гоблины страшноватые 
sv	Spöken och troll, väldigt läskigt 
th	ผีและปีศาจน่ากลัวจัง 
tr	Hayaletler ve cinler korkunçtur 
vi	Ma quỷ và yêu tinh rất đáng sợ 
zh-long	鬼魂、妖怪好可怕 
zh-short	妖魔鬼怪十分可怕 

