en	[banging continues] | 

no	Det å kødde med Shoobie Dubois er en Salem-tradisjon. 
ar	‫العبث مع "شوبي دوبوا". تقليد في "سايلم".‬ | 
cs	Vypečeme Hubanoise Duboise. Salemská tradice. 
da	At tage pis på Shoobie Dubois. En Salem-tradition. 
de	Shoobie Dubois ärgern hat in Salem Tradition. 
el	Φάρσα στον Θρούμπι Ντουμπουά. Παράδοση του Σάλεμ. 
en	Messing with Shoobie Dubois. A Salem tradition. 
es-eu	Meterse con Dubois. Una tradición de Salem. 
es	Molestar a Shoobie Dubois, una tradición de Salem. 
fi	Shoobie Dubois'n kiusaaminen. Salemin perinne. 
fr	S'en prendre à Choubie Dubois. Une tradition à Salem. 
he	‫לעבוד על שובי דובואה.‬ | ‫מסורת של סיילם.‬ | 
hr	Zezanje Shoobieja Duboisa. Salemska tradicija. 
it	Prendersela con Dubois. Una tradizione di Salem. 
ja	&lrm;セーラムの | &lrm;オモチャって感じだな | 
ko	슈비 뒤부아 괴롭히기는 역시 세일럼의 전통이지 
nl	Shoobie Dubois pesten. Een Salem-traditie. 
pl	Psikus Shoobiemu Dubois. Salemska tradycja. 
pt-br	Sacanear o Shoobie Dubois. Uma tradição de Salém. 
pt	Gozar com o Shoobie Dubois. Uma tradição de Salem. 
ro	Să râzi de Shoobie Dubois e o tradiție în Salem. 
sv	Jävlas med Shoobie Dubois, en Salem-tradition. 
th	แกล้งชูบี้ ดูบัวส์ ตามธรรมเนียมเซเล็ม 
vi	Trêu chọc Shoobie Dubois. Truyền thống Salem. 
zh-long	捉弄修比杜布瓦是颯冷鎮的傳統 
zh-short	耍混蛋·杜布瓦 是塞勒姆的传统 
id	Mengisengi Shoobie Dubois. Tradisi Salem. | 
ms	Asyik sakat Shoobie Dubois. Setiap tahun jadi mangsa. 
hu	Shoobie Dubois-t szívatni… Salemi hagyomány. 
ru	Подшучивание над Шуби Дюбуа — салемская традиция. 
tr	Shoobie Dubois'ya bulaşmak. Tam bir Salem geleneği. 

