en	[laughs] | 

ms	Tumpang lalu. 
es	Permiso, novia de Zorranstein. Gracias. 
hr	Ispričavam se, Droljensteinova nevjesto. Hvala. 
el	Συγγνώμη, Τσούλα του Φρανκενστάιν. 
ar	‫اعذريني يا "عروس سكانكنستاين". أجل، شكرًا.‬ | 
cs	Pardon, Frankensteinova nevěstko. Jo, díky. 
da	Pas på, Frankensteins brud. Tak. 
en	Excuse me, excuse me, Bride of Skankenstein. Yeah, thank you. 
fi	Anteeksi, Frankensteinin horo. Kiitos. 
fr	Excuse-moi, épouse de Pouffenstein. Oui, merci. 
he	‫סליחה, הזונה של פרנקנשטיין.‬ | ‫כן, תודה.‬ | 
hu	Elnézést, Borzenstein menyasszonya! Köszi! 
it	Scusa, sposa di Stercostein. Sì, grazie. 
ko	비켜봐, 여자 프랑켄슈타인 고맙다 
nl	Pardon, bruid van Slettenstein. Dank je. 
ro	Scuză-mă, mireasa lui Târfănstein! Mersi. 
ru	Извини, Невеста Шлюшкенштейна. Спасибо. 
sv	Ursäkta, Fnaskensteins brud. Ja, tack. 
th	โทษนะ เจ้าสาวของแชงเก้นสไตน์ ขอบใจนะ 
tr	Pardon Kaşarenstein. Evet, teşekkürler. 
zh-long	科學爛人的新娘，借過，謝謝 
zh-short	让一下 科学怪人的缺德新娘 好 谢谢 
de	Pardon, Frankensteins Schlampe. Ja, danke. 
vi	Xin lỗi, Cô dâu của Skankenstein. Ừ, cảm ơn. 
es-eu	Disculpa, novia de Francacatenstein. Gracias. 
ja	&lrm;そこのイヤな女　どいて | 
no	Unnskyld, Frankensteins tøs. Takk. 
pl	Przepraszam, narzeczono Skankensteina. Dziękuję. 
pt	Com licença, noiva de Skankenstein. Sim, obrigada. 
pt-br	Com licença, noiva do Piranhenstein. Sim, obrigada. 
id	Permisi, Pengantin Somplakenstein. | Ya, terima kasih. | 
ms	Pengantin Skankenstein. Terima kasih. 
el	Ευχαριστώ. 

