en	[dance rhythm playing] | 

ar	‫ما هذا يا "مايك" بحق الجحيم؟ لم فعلت ذلك؟‬ | 
cs	Co blbneš, Mikeu? Proč tohle děláš? 
da	Hvad fanden? Hvorfor gjorde du det? 
de	Verdammt, Mike! Warum hast du das getan? 
el	Τι διάολο, Μάικ; Γιατί το έκανες αυτό; 
en	What the hell, Mike? Why would you do that? 
es-eu	¡Madre mía, Mike! ¿Por qué haces eso? 
es	¿Qué diablos, Mike? ¿Por qué hiciste eso? 
fi	Mitä hittoa, Mike? Miksi teit noin? 
fr	Nom d'un chien, Mike ! Pourquoi t'as fait ça ? 
he	‫מה לעזאזל, מייק?‬ | ‫למה שתעשה את זה?‬ | 
hr	Koji vrag, Mike? Zašto si to učinio? 
hu	Mi a fene, Mike? Miért csináltad ezt? 
id	Apa-apaan, Mike? Kenapa kau lakukan itu? | 
it	Ma che diavolo, Mike? Perché l'hai fatto? 
ja	&lrm;マイク　何のまね？ | 
ko	너 뭐야, 마이크, 왜 이러는 건데? 
ms	Celaka, Mike! Kenapa buat macam itu? 
nl	Verdomme, Mike. Waarom doe je dat? 
no	Hvorfor gjør du sånt, Mike? 
pl	Co jest, Mike? Dlaczego to zrobiłeś? 
pt-br	Que droga, Mike! Por que fez isso? 
pt	Mas que raio, Mike? Porque farias isso? 
ro	Ce naiba, Mike? De ce ai făcut asta? 
ru	Какого чёрта, Майк? Зачем ты это сделал? 
sv	Vad fan, Mike? Varför gjorde du så? 
th	อะไรนี่ ไมค์ นายทำแบบนี้ทำไม 
tr	Ne yapıyorsun Mike? Bunu neden yaptın? 
vi	Cái quái gì thế, Mike? Sao cậu làm thế? 
zh-long	搞什麼，麥克？你幹嘛這樣？ 
zh-short	什么鬼 迈克？你为什么这样？ 

