en	[laughs] | 

it	Ha iniziato a dipingerli un anno fa. 
nl	Een jaar geleden begon hij met dit. 
es	Empezó a pintarlos hace un año. 
id	Dia mulai melukis ini setahun lalu. 
zh-short	他一年前开始画这些 
zh-long	他一年前開始畫這些畫 
hr	Lani je to počeo slikati. 
sv	Han började måla för ett år sen. 
pt-br	Ele começou a pintá-los há um ano. 
fi	Hän alkoi tehdä näitä vuosi sitten. | 
da	Han begyndte på dem for et år siden. | 
el	Άρχισε να ζωγραφίζει πριν έναν χρόνο. 
en	He started painting these a year ago. 
es-eu	Empezó a pintarlos hace un año. 
fr	Il a commencé à peindre il y a un an. 
he	‫הוא התחיל לצייר אותם לפני שנה.‬ | 
hu	Egy éve kezdte festeni ezeket. 
ja	&lrm;１年前から描き始めた | 
ko	&lrm;1년 전부터 | &lrm;이런 그림을 그렸어요 | 
no	Han malte disse for et år siden. 
pt	Ele começou a pintar isso há um ano. 
ro	Asta pictează de un an. 
th	&lrm;เขาเริ่มวาดรูปพวกนี้เมื่อปีก่อน | 
tr	Bu resimlere bir yıl önce başlamıştı. 
vi	&lrm;Nó bắt đầu vẽ mấy bức này | &lrm;từ một năm trước. | 
cs	Začal je malovat před rokem. 
ms	Dia mula melukis setahun lalu. 
uk	Він почав малювати це рік тому. 
ru	Он начал рисовать их год назад. 

