en	[laughs] | 

el	Μόλις απάντησες στην ερώτησή μου. 
es	Eso responde mi pregunta. 
pt	Isso respondeu à minha pergunta. 
ar	‫أجاب ذلك على سؤالي.‬ | 
cs	Tím je má otázka zodpovězena. 
da	Der fik jeg mit svar. 
en	That just answered my question. 
es-eu	Eso responde a mi pregunta. 
fr	J'ai la réponse à ma question. 
he	‫זה ענה על השאלה שלי.‬ | 
hu	Ez válasz a kérdésemre. 
it	È la risposta alla mia domanda. 
ko	대답은 충분히 됐네요 
nl	Ik weet genoeg. 
ru	Вот и ответ на мой вопрос. 
sv	Det besvarade min fråga. 
th	นั่นมันตอบคำถามของผมแล้วละ 
tr	Bu sorumu yanıtladı. 
vi	Thắc mắc đã được giải đáp. 
zh-long	我已經知道答案了 
zh-short	你已经回答了我的问题 
id	Itu menjawab pertanyaanku. | 
pl	To mi wystarczy za odpowiedź. 
ms	Itu baru menjawab soalan saya. 
pt-br	Isso respondeu minha pergunta. 
ro	Asta mi-a răspuns la întrebare. 
de	Das beantwortet meine Frage. 
fi	Tuo vastasi juuri kysymykseeni. 
hr	Time ste mi odgovorili na pitanje. 
ja	&lrm;今ので分かったぞ | 
no	Der besvarte du spørsmålet mitt. 

