en	[laughs] | 

ar	‫لست قلقة بشأني. أنا قلقة على أطفالي.‬ | 
cs	O sebe strach nemám. Bojím se o děti. 
da	Jeg passer ikke på mig selv, jeg passer på mine børn. 
de	Ich mache mir keine Sorgen um mich, nur um meine Kinder. 
el	Δεν ανησυχώ για μένα. Ανησυχώ για τα παιδιά μου. 
en	Oh, well, I don't worry about me. I worry about my kids. 
es-eu	No me preocupo por mí. Me preocupo por mis hijos. 
es	No estoy preocupada por mí, sino por mis hijos. 
fi	En ole huolissani itsestäni, vaan lapsistani. 
fr	Je ne m'inquiète pas pour moi, mais plutôt pour mes enfants. 
he	‫אני לא דואגת לעצמי.‬ | ‫אני דואגת לילדים שלי.‬ | 
hu	Hát, magam miatt nem aggódom. Csak a gyerekeimért. 
id	Aku tak mencemaskan diriku, | tetapi anak-anakku. | 
it	Beh, non mi preoccupo per me. Ma per i miei figli. 
ja	&lrm;私は平気　子供たちが心配よ | 
ko	내 걱정은 안 해, 애들이 걱정되지 
ms	Saya risau tentang anak-anak saya saja. 
nl	Ik maak me geen zorgen om mij, maar om mijn kinderen. 
no	Jeg er ikke bekymret for meg selv, men for barna mine. 
pl	Nie martwię się o siebie. Martwię się o dzieci. 
pt-br	Não me preocupo comigo, só com os meus filhos. 
pt	Não me preocupo comigo. Preocupo-me com os meus filhos. 
ro	Eu nu-mi fac griji pentru mine, ci pentru copiii mei. 
ru	Я не за себя волнуюсь, а за моих детей. 
sv	Jag oroar mig inte för mig själv, utan för mina barn. 
th	ฉันไม่ห่วงตัวฉันหรอก ฉันห่วงลูกๆ ของฉัน 
tr	Kendimi dert etmiyorum. Çocuklarımı dert ediyorum. 
vi	Ồ, tớ không lo cho mình. Tớ lo cho các con. 
zh-long	我不擔心自己，只擔心孩子 
zh-short	我不担心自己 我担心我的孩子们 
hr	Ne brinem se za sebe. Brinem se za svoju djecu. 

