id	Mengenalku lebih baik? Aku duduk di pangkuanmu. 
ja	今さら？ | ヒザに乗せといて？ | 
en	[Charlie] Know me better? | I'm sitting on your lap. | 

es	Si no te gusta, lárgate. 
cs	Tak si jdi, když se ti to nelíbí! 
fi	Lähtekää, jos haluatte. | 
pt-br	Se não está a fim, pode vazar. 
da	Du kan jo bare skride. | 
el	Αν δεν σ' αρέσει, πάρε δρόμο. 
en	If you don't like it, fuck off. 
es-eu	Si no te gusta, lárgate. 
fr	On ne t'oblige pas à rester. 
he	‫אם זה לא נראה לך, תתחפף מפה.‬ | 
hr	Ako ti se ne sviđa, odjebi. 
id	Jika kau tak suka, pergilah. 
it	Se non ti piace, vaffanculo. 
ko	&lrm;싫으면 꺼져 | 
pt	Se não gostas, põe-te a milhas. 
ro	Dacă nu îți place, pleacă! 
ru	Не хочешь помогать — отвали. 
th	&lrm;ถ้าไม่อยากทำก็ไสหัวไป | 
tr	Hoşuna gitmediyse siktir git. 
uk	Якщо не подобається, забирайся. 
vi	&lrm;Nếu không thích thì biến đi. | 
zh-long	如果你不想幫忙就滾蛋 
zh-short	不想做就滚 
hu	Ha nem tetszik, húzz a picsába! 
ms	Kalau awak tak suka, berambus. 
ja	&lrm;やりたくないなら 失せな | 
no	Om du ikke liker det, dra til helvete. 
sv	Om du inte vill, så dra åt helvete. 

