en	I never said that. | 
ja	王じゃない | 

pt-br	Posso ajudar? 
cs	Můžu vám nějak pomoct? 
da	Kan jeg hjælpe Dem? | 
el	Μπορώ να σας βοηθήσω; 
en	Can I help you? 
es-eu	¿Desean algo? 
es	¿Puedo ayudarlos? 
fi	Voinko olla avuksi? | 
fr	Je peux vous aider ? 
he	‫אפשר לעזור לכם?‬ | 
hr	Mogu li vam pomoći? 
hu	Segíthetek? 
id	Ada yang bisa kubantu? 
it	Posso aiutarvi? 
ja	&lrm;何かご用？ | 
ko	&lrm;어떻게 오셨나요? | 
ms	Boleh saya bantu? 
nl	Kan ik u helpen? 
no	Kan jeg hjelpe? 
pt	Posso ajudar-vos? 
ro	Vă pot ajuta cu ceva? 
ru	Чем могу помочь? 
sv	Kan jag hjälpa till? 
th	&lrm;มีอะไรให้ช่วยมั้ยคะ | 
tr	Yardımcı olabilir miyim? 
uk	Чим можу допомогти? 
vi	&lrm;Tôi có thể giúp gì? | 
zh-long	有什麼事嗎？ 
zh-short	需要帮忙吗？ 

