en	[woman singing nearby] | 

cs	„Mlč a bude to v pohodě. 
en	"Keep quiet and it'll be okay." 
es-eu	"Cállate y no pasará nada. 
fr	"Ferme-la et ça ira. 
he	‫"אל תדבר והכול יהיה בסדר.‬ | 
hr	„Samo šuti i sve pet. 
it	"Stai zitto e andrà tutto bene. 
ja	&lrm;“黙っとけばいい” | 
ko	&lrm;'조용히 있으면 괜찮아' | 
ms	"Diam dan akan selamat. 
no	"Vær stille, så går det bra." 
pt	"Cala-te e não há problema. 
ro	„Taci și o să fie bine. 
ru	«Молчи, всё обойдется. 
sv	"Håll tyst så gör de inte det. 
th	&lrm;"เงียบไว้แล้วจะเรียบร้อยเอง" | 
tr	"Susarsan sorun olmaz. 
vi	&lrm;"Cứ im lặng và sẽ ổn thôi". | 
zh-long	“閉嘴就沒事 
zh-short	“别说出去就没事” 
da	"Hold mund, så skal det nok gå." | 
el	"Μη μιλήσεις. Όλα θα πάνε καλά. 
id	"Tutup mulutmu, semua akan baik-baik saja. 
pt-br	"Fique quieto e tudo ficará bem. 
nl	'Hou je mond, dan komt het goed.' 
uk	«Просто мовчи, і все буде гаразд. 
hu	„Hallgass, és minden rendben lesz.” 
es	"Quédate callado y todo estará bien. 
fi	"Kaikki järjestyy, jos pysyt hiljaa. | 

