id	- Selalu. - Para manajer terbiasa berbohong, 
ja	常に | 

es	Apúrate. Salimos en cinco minutos. 
id	Cepatlah. Kita berangkat lima menit lagi. 
zh-short	快点 我们五分钟后出发 
fi	Lähdemme viiden minuutin päästä. | 
zh-long	快點，我們五分鐘後出發 
cs	Dělej. Za pět minut vyrážíme. 
el	Γρήγορα. Φεύγουμε σε πέντε λεπτά. 
hr	Požuri se. Za pet minuta idemo. 
sv	Skynda dig. Vi åker om fem minuter. 
tr	Çabuk, beş dakikaya çıkıyoruz. 
en	Hurry up. We're leaving in five minutes. 
fr	Vite. On part dans cinq minutes. 
uk	Збирайся. Виходимо через п'ять хвилин. 
it	Sbrigati, usciamo tra cinque minuti. 
nl	Schiet op. We vertrekken over vijf minuten. 
da	Skynd dig lidt. Vi kører om fem minutter. | 
es-eu	Date prisa. Nos vamos en cinco minutos. 
he	‫תזדרזי. אנחנו יוצאים עוד חמש דקות.‬ | 
hu	Siess már! Öt perc múlva indulunk. 
ja	&lrm;急げ　あと５分で行くぞ | 
ko	&lrm;서둘러, 5분 후에 출발한다 | 
ms	Cepat. Lagi lima minit kita bertolak. 
no	Fort deg. Vi drar om fem minutter. 
pt-br	Ande! Saímos em cinco minutos. 
pt	Mexe-te. Saímos daqui a cinco minutos. 
ro	Să te grăbești! Plecăm în cinci minute! 
th	&lrm;เร็วเข้า อีกห้านาทีจะออกแล้วนะ | 
vi	&lrm;Nhanh lên. Năm phút nữa ta sẽ đi. | 
ru	Быстрее. Через пять минут выходим. 

